45 25
12 12 12 12 12 12 12 12 12 12 12 12 12 12 12 12 12 12 12 12 12 12 12 12 12 12 12 12 12 12 12 12 12 12 12 12 12 12 12 12 12 12 12 12 12
12 12 12 12 12 12 15 15 15 15 15 15 15 15 15 15 15 12 12 12 12 12 15 12 12 12 12 12 15 15 15 15 15 15 15 15 15 15 15 12 12 12 12 12 12
12 12 12 12 12 12 15 15 15 15 15 15 15 15 15 15 15 12 12 12 12 15 15 15 12 12 12 12 15 15 15 15 15 15 15 15 15 15 15 12 12 12 12 12 12
12 12 12 12 12 12 15 15 15 15 15 15 15 15 15 15 15 12 12 12 15 15 15 15 15 12 12 12 15 15 15 15 15 15 15 15 15 15 15 12 12 12 12 12 12
15 15 15 15 15 15 15 15 15 15 15 15 15 15 15 15 15 12 12 15 15 15 15 15 15 15 12 12 15 15 15 15 15 15 15 15 15 15 15 15 15 15 15 15 15
15 15 15 15 15 15 15 15 15 15 15 15 15 15 15 15 15 12 15 15 15 15 15 15 15 15 15 12 15 15 15 15 15 15 15 15 15 15 15 15 15 15 15 15 15
15 15 15 15 15 15 15 15 15 15 15 15 15 15 15 15 15 15 15 15 15 15 15 15 15 15 15 15 15 15 15 15 15 15 15 15 15 15 15 15 15 15 15 15 15
15 15 15 15 15 15 15 15 15 15 15 15 15 15 15 15 15 15 15 15 15 15 15 15 15 15 15 15 15 15 15 15 15 15 15 15 15 15 15 15 15 15 15 15 15
15 15 15 15 15 15 15 15 15 15 15 15 15 15 15 15 15 15 15 15 15 15 15 15 15 15 15 15 15 15 15 15 15 15 15 15 15 15 15 15 15 15 15 15 15
15 15 15 15 15 15 15 15 15 15 15 15 15 15 15 15 15 15 15 15 15 15 15 15 15 15 15 15 15 15 15 15 15 15 15 15 15 15 15 15 15 15 15 15 15
15 15 15 15 15 15 15 15 15 15 15 15 15 15 15 15 15 15 15 15 15 15 15 15 15 15 15 15 15 15 15 15 15 15 15 15 15 15 15 15 15 15 15 15 15
15 15 15 15 15 15 15 15 15 15 15 15 15 15 15 15 15 15 15 15 15 15 15 15 15 15 15 15 15 15 15 15 15 15 15 15 15 15 15 15 15 15 15 15 15
15 15 15 15 15 15 15 15 15 15 15 15 15 15 15 15 15 15 15 15 15 15 15 15 15 15 15 15 10 15 15 15 15 15 15 15 15 15 15 15 15 15 15 15 15
15 15 15 15 15 15 15 15 15 15 15 15 15 15 15 15 15 15 15 15 15 15 15 15 15 15 9 9 9 9 9 15 15 15 15 15 15 15 15 15 15 15 15 15 15
15 15 15 15 15 15 15 15 15 15 15 15 15 15 15 15 15 15 15 15 15 15 15 15 15 15 15 15 15 15 15 15 15 15 15 15 10 15 15 15 15 15 15 15 15
15 15 15 15 15 15 15 15 15 15 15 15 15 15 15 15 15 15 15 15 15 15 15 15 9 9 9 9 9 15 15 15 15 9 9 9 9 9 15 15 15 15 15 15 15
15 15 15 15 15 15 15 15 15 15 15 15 15 15 15 15 15 15 15 15 15 15 15 15 15 15 15 15 15 15 15 15 15 15 15 15 15 15 15 15 15 15 15 15 15
15 15 15 15 15 15 15 15 15 15 15 15 15 15 15 15 15 15 15 15 15 15 9 9 9 9 9 15 15 15 15 15 15 15 15 15 15 15 15 15 15 15 15 15 15
15 15 15 15 15 15 15 15 15 9 9 15 15 15 15 15 15 15 15 15 15 15 15 15 15 15 15 15 15 15 15 15 15 15 15 15 15 15 15 15 15 15 15 15 15
1 2 15 15 15 15 15 15 15 15 15 15 15 15 15 15 15 15 15 15 9 9 9 9 15 15 15 15 15 15 15 15 15 15 15 15 15 15 15 15 15 15 15 0 1
4 5 15 15 15 9 9 15 15 15 15 15 15 15 15 15 15 9 15 15 15 15 15 15 15 15 15 15 15 15 15 15 15 15 15 15 15 15 15 15 15 15 15 3 4
7 8 11 15 15 15 15 15 15 15 15 15 15 15 15 15 15 15 15 15 15 15 15 15 15 10 15 15 15 15 15 15 15 15 15 15 15 15 15 15 15 15 15 6 7
12 12 12 12 14 14 14 14 14 14 14 14 12 12 12 12 15 15 15 15 12 12 12 12 12 12 12 12 14 14 14 12 12 12 12 12 12 12 14 14 12 12 12 12 12
12 12 12 12 14 14 14 14 14 14 14 14 12 12 12 12 15 15 15 15 12 12 12 12 12 12 12 14 14 14 14 12 12 12 12 12 12 12 14 14 12 12 12 12 12
12 12 12 12 14 14 14 14 14 14 14 14 12 12 12 12 15 15 15 15 12 12 12 12 12 12 14 14 14 14 14 12 12 12 12 12 12 12 14 14 12 12 12 12 12
