45 25
15 15 15 15 15 15 15 15 15 15 15 15 15 15 15 15 15 15 15 15 15 15 15 15 15 15 15 15 15 15 15 15 15 15 15 15 15 15 15 15 15 15 15 15 15
15 15 15 15 15 15 15 15 15 15 15 15 15 15 15 15 15 15 15 15 15 15 15 15 15 15 15 15 15 15 15 15 15 15 15 15 15 15 15 15 15 15 15 15 15
15 15 15 15 15 15 15 15 15 15 15 15 15 15 15 15 15 15 15 15 15 15 15 15 15 15 15 15 15 15 15 15 15 15 15 15 15 15 15 15 15 15 15 15 15
15 15 15 15 15 15 15 15 15 15 15 15 15 15 15 15 15 15 15 15 15 15 15 15 15 15 15 15 15 15 15 15 15 15 15 15 15 15 15 15 15 15 15 15 15
15 15 15 15 15 15 15 15 15 15 15 15 15 15 15 15 15 15 15 15 15 15 15 15 15 15 15 15 15 15 15 15 15 15 15 15 15 15 15 15 15 15 15 15 15
15 15 15 15 15 15 15 15 25 26 27 28 25 26 27 28 25 26 27 28 25 26 27 28 25 26 27 28 25 26 27 28 25 26 27 28 25 26 27 28 25 26 27 28 25
15 15 15 15 15 15 15 15 29 30 32 31 29 30 32 31 29 30 32 31 29 30 32 31 29 30 32 31 29 30 32 31 29 30 32 31 29 30 32 31 29 30 32 31 29
15 15 15 15 15 15 15 15 15 15 15 15 15 15 15 15 15 15 15 15 15 15 15 15 15 15 15 15 15 15 15 15 15 15 15 15 15 15 15 15 15 15 15 15 15
15 15 15 15 15 15 15 15 15 15 15 15 15 15 15 15 15 15 15 15 15 15 15 15 15 15 15 15 15 15 15 15 15 15 15 15 15 15 15 15 15 15 15 15 15
15 15 15 15 15 15 15 15 15 15 15 15 15 15 15 15 15 15 15 15 15 15 15 15 15 15 15 15 15 15 15 15 15 15 15 15 15 15 15 15 15 15 15 15 15
15 15 15 15 15 15 15 15 15 15 15 15 15 15 15 15 15 15 15 15 15 15 15 15 15 15 15 15 15 15 15 15 15 15 15 15 15 15 15 15 15 15 15 15 15
15 15 15 15 15 15 15 15 15 15 15 15 15 15 15 15 15 15 15 15 15 15 15 15 15 15 15 15 15 15 15 15 15 15 15 15 15 15 15 15 15 15 15 37 38
15 15 15 15 15 15 15 15 15 15 15 15 15 15 15 15 15 15 15 15 15 15 15 15 15 15 15 15 15 15 15 15 15 15 15 15 15 15 15 15 15 15 15 39 40
15 15 15 15 15 15 15 15 15 15 15 15 15 15 15 15 15 15 15 15 15 15 15 15 15 15 15 15 15 15 15 15 15 15 41 15 15 15 15 15 19 19 19 19 19
15 15 15 15 15 15 15 15 15 15 15 15 15 15 15 15 15 15 15 15 15 15 15 15 15 15 15 15 15 15 15 15 19 19 19 19 19 15 15 15 15 15 15 15 15
33 34 15 15 15 15 15 15 15 15 15 15 15 15 15 15 15 15 15 15 15 15 15 15 15 15 25 26 27 15 15 15 15 15 15 15 15 15 15 15 15 15 15 15 15
35 36 15 15 15 15 15 15 15 15 15 15 15 15 15 15 15 15 15 15 15 15 15 15 15 15 29 30 32 15 15 15 15 15 15 15 15 15 15 15 15 15 15 15 15
16 16 16 15 15 15 15 15 15 15 15 15 15 15 41 15 15 15 15 15 25 26 27 28 15 15 15 15 15 15 15 15 15 15 15 15 15 15 15 15 15 15 15 15 15
24 24 24 16 16 15 15 15 15 15 15 15 25 26 27 28 28 15 15 15 29 30 32 31 15 15 15 15 15 15 15 15 15 15 15 15 15 15 15 15 15 15 15 15 15
24 24 24 24 24 16 16 15 15 15 15 15 29 30 32 31 31 15 15 15 15 15 15 15 15 15 15 15 15 15 15 15 15 15 15 15 15 15 15 15 15 15 15 15 15
15 15 15 15 15 15 15 15 15 15 15 15 15 41 15 41 15 15 15 15 15 15 15 15 15 15 15 15 15 15 15 25 26 27 28 15 15 15 15 15 15 15 15 15 15
15 15 15 15 15 15 15 15 15 15 16 16 16 16 16 16 16 16 15 15 15 15 15 15 15 15 15 15 15 15 15 29 30 32 31 15 15 15 15 15 15 15 15 15 15
15 15 15 15 15 15 15 15 15 16 24 24 24 24 24 24 24 24 16 16 15 15 15 15 15 41 41 15 15 15 15 15 15 15 15 15 15 15 15 15 15 15 15 15 15
16 16 16 16 16 16 16 16 16 24 24 24 24 24 24 24 24 24 24 24 15 15 15 15 16 16 16 16 16 16 14 14 14 14 14 14 14 16 16 16 16 16 16 16 16
24 24 24 24 24 24 24 24 24 24 24 24 24 24 24 24 24 24 24 24 41 41 41 41 24 24 24 24 24 24 14 14 14 14 14 14 14 24 24 24 24 24 24 24 24