45 25
15 15 15 15 15 15 15 15 15 24 24 15 15 15 15 15 15 15 15 15 15 15 24 24 15 15 15 15 15 15 15 15 15 15 15 15 15 15 15 15 15 15 15 15 15
15 15 15 15 15 15 15 15 15 24 24 15 15 15 15 15 15 15 15 15 15 15 24 24 15 15 15 15 15 15 15 15 15 15 15 15 15 15 15 15 15 15 15 15 15
25 26 27 28 25 26 27 28 25 24 24 15 15 15 15 15 15 15 15 15 15 15 24 24 15 15 15 15 15 15 15 15 15 15 15 15 15 15 15 15 15 15 15 15 15
29 30 32 31 29 30 32 31 29 24 24 15 15 15 15 15 15 15 15 15 15 15 24 24 15 15 15 15 15 15 15 15 15 15 15 15 15 15 15 15 15 15 15 15 15
15 15 15 15 15 15 15 15 15 24 24 15 15 15 15 15 15 15 15 15 15 15 24 24 15 15 15 15 15 15 15 15 15 15 15 15 15 15 15 15 15 15 15 15 15
15 15 15 15 15 15 15 15 15 24 24 15 15 15 15 15 15 15 15 15 15 15 24 24 15 15 15 15 15 15 15 15 15 15 15 15 15 15 15 15 15 15 15 15 15
15 15 15 15 15 15 15 15 15 24 24 15 15 15 15 15 15 15 15 15 15 15 24 24 15 15 15 15 15 15 15 15 15 15 15 15 15 15 15 15 15 15 15 15 15
15 15 15 15 15 15 15 15 15 24 24 15 15 15 15 15 15 15 15 15 15 15 24 24 15 15 15 15 15 15 15 15 15 15 15 15 15 15 15 15 15 15 15 15 15
15 15 15 15 15 15 15 15 15 24 24 15 15 15 15 15 15 15 15 15 15 15 24 24 15 15 15 15 15 15 15 15 15 15 15 15 15 15 15 15 15 15 15 15 15
15 15 15 15 15 15 15 15 15 24 24 15 15 15 15 15 15 15 15 15 15 15 24 24 15 15 15 15 15 15 15 15 15 15 15 15 15 15 15 15 15 15 15 15 15
15 15 15 15 15 15 15 15 15 24 24 15 15 15 15 15 15 15 15 15 15 15 43 43 15 15 15 15 15 15 15 15 15 15 15 15 15 15 15 15 15 15 15 15 15
15 15 15 15 15 15 15 15 15 24 24 15 15 15 15 15 15 15 15 15 15 15 15 15 15 15 15 15 15 15 15 15 15 15 15 15 15 15 15 15 15 15 15 15 15
15 15 15 15 15 15 15 15 15 24 24 15 15 15 15 15 15 15 15 15 15 15 15 15 15 15 15 15 15 15 15 15 15 15 15 15 15 15 15 15 15 15 15 15 15
15 15 15 15 15 15 15 15 15 24 24 15 15 15 15 15 15 15 15 15 15 15 15 15 15 15 15 15 15 15 15 15 15 15 15 15 15 15 15 15 15 15 15 15 15
15 15 15 15 15 15 15 15 15 43 43 15 15 15 15 15 15 15 15 15 15 15 15 15 15 15 15 41 15 15 15 15 15 15 15 15 15 15 15 15 15 15 15 15 15
33 34 15 15 15 15 15 15 15 15 15 15 15 15 15 15 15 15 15 15 15 15 15 15 15 15 25 26 27 28 15 15 15 15 15 15 15 15 15 15 15 15 15 15 15
35 36 15 15 15 15 15 15 15 15 15 15 15 15 15 15 15 15 15 15 15 15 15 15 15 15 29 30 32 31 15 15 15 15 15 15 15 15 15 15 15 15 15 15 15
16 16 16 41 41 15 15 15 15 15 15 15 15 15 15 15 15 15 15 25 25 42 42 28 15 15 15 15 15 15 15 15 15 15 15 15 15 15 15 15 15 15 15 15 15
24 24 24 16 16 15 15 15 15 15 15 15 25 42 42 28 15 15 15 29 29 15 15 31 15 15 15 15 15 15 15 15 15 15 15 15 15 15 15 15 15 44 24 24 24
24 24 24 24 24 16 16 15 15 15 15 15 29 15 15 31 15 15 15 15 15 15 15 15 15 15 15 15 15 15 15 15 15 15 15 15 15 15 15 15 15 44 24 24 24
15 15 15 15 15 15 15 15 15 15 15 15 15 15 15 15 15 15 15 15 15 15 15 15 15 15 15 15 15 15 15 15 15 15 15 15 15 15 15 15 15 15 15 37 38
37 38 15 15 15 15 15 15 15 15 16 16 16 16 16 16 16 16 15 15 15 15 15 15 15 15 15 15 15 15 15 15 15 15 15 15 15 15 15 15 15 15 15 39 40
39 40 15 15 15 15 15 15 15 16 24 24 24 24 24 24 24 24 16 16 15 15 15 15 15 15 15 15 15 15 15 15 15 15 15 15 15 16 16 16 16 16 16 16 16
16 16 16 16 16 16 42 42 16 24 24 24 24 24 24 24 24 24 24 24 16 42 42 42 16 16 16 16 16 16 16 15 15 25 26 27 15 24 24 24 24 24 24 24 24
24 24 24 24 24 24 24 24 24 24 24 24 24 24 24 24 24 24 24 24 24 42 42 42 24 24 24 24 24 24 24 15 15 29 30 32 15 24 24 24 24 24 24 24 24